//MAP CONVERTED BY dmm2tgm.py THIS HEADER COMMENT PREVENTS RECONVERSION, DO NOT REMOVE
"a" = (
/turf/template_noop,
/area/template_noop)
"c" = (
/obj/effect/decal/cleanable/dirt,
/obj/effect/turf_decal/stripes/line{
	dir = 5
	},
/obj/structure/window/reinforced,
/obj/effect/turf_decal/box/corners{
	dir = 4
	},
/obj/effect/turf_decal/box/corners,
/turf/open/floor/mineral/plastitanium,
/area/shuttle/mining/skyline)
"d" = (
/obj/effect/turf_decal/bot,
/obj/machinery/computer/shuttle/common_docks,
/turf/open/floor/mineral/plastitanium,
/area/shuttle/mining/skyline)
"e" = (
/obj/machinery/mining_laser{
	dir = 1
	},
/turf/closed/wall/mineral/titanium/nodiagonal,
/area/shuttle/mining/skyline)
"f" = (
/obj/structure/window/reinforced,
/obj/structure/window/reinforced,
/obj/structure/ore_box,
/obj/item/storage/bag/ore,
/obj/effect/turf_decal/box/corners,
/turf/open/floor/mineral/plastitanium,
/area/shuttle/mining/skyline)
"g" = (
/obj/effect/turf_decal/stripes/line{
	dir = 9
	},
/obj/structure/closet/crate/bin,
/obj/item/radio/intercom/wideband/directional/west,
/turf/open/floor/mineral/titanium/yellow,
/area/shuttle/mining/skyline)
"h" = (
/obj/structure/chair/comfy/shuttle{
	dir = 1
	},
/obj/effect/turf_decal/stripes/line{
	dir = 1
	},
/turf/open/floor/mineral/titanium/yellow,
/area/shuttle/mining/skyline)
"i" = (
/obj/effect/turf_decal/stripes/line{
	dir = 5
	},
/obj/structure/table,
/turf/open/floor/mineral/titanium/yellow,
/area/shuttle/mining/skyline)
"j" = (
/obj/effect/decal/cleanable/dirt,
/obj/structure/chair/comfy/shuttle{
	dir = 4
	},
/obj/structure/window/reinforced,
/obj/effect/turf_decal/box/corners{
	dir = 8
	},
/turf/open/floor/mineral/plastitanium,
/area/shuttle/mining/skyline)
"l" = (
/obj/effect/decal/cleanable/dirt,
/obj/machinery/light/directional/west,
/obj/effect/turf_decal/box/corners{
	dir = 4
	},
/obj/effect/turf_decal/box/corners{
	dir = 1
	},
/obj/structure/chair/comfy/shuttle{
	dir = 4
	},
/turf/open/floor/mineral/plastitanium,
/area/shuttle/mining/skyline)
"m" = (
/obj/effect/turf_decal/stripes/line{
	dir = 8
	},
/obj/machinery/atmospherics/components/unary/vent_scrubber/on/layer2{
	dir = 4
	},
/turf/open/floor/mineral/titanium/yellow,
/area/shuttle/mining/skyline)
"n" = (
/obj/effect/mapping_helpers/smart_pipe/manifold4w/supply/hidden/layer4,
/obj/effect/mapping_helpers/smart_pipe/manifold4w/scrubbers/hidden/layer2,
/turf/open/floor/mineral/titanium/yellow,
/area/shuttle/mining/skyline)
"o" = (
/obj/effect/decal/cleanable/dirt,
/obj/effect/turf_decal/stripes/line{
	dir = 4
	},
/obj/machinery/atmospherics/components/unary/vent_pump/on/layer4{
	dir = 8
	},
/turf/open/floor/mineral/titanium/yellow,
/area/shuttle/mining/skyline)
"p" = (
/obj/effect/decal/cleanable/dirt,
/obj/machinery/airalarm/directional/east,
/obj/machinery/light/directional/east,
/obj/machinery/transporter,
/obj/effect/turf_decal/box/corners{
	dir = 4
	},
/obj/effect/turf_decal/box/corners{
	dir = 1
	},
/turf/open/floor/mineral/plastitanium,
/area/shuttle/mining/skyline)
"q" = (
/obj/effect/spawner/structure/window/shuttle,
/turf/open/floor/plating,
/area/shuttle/mining/skyline)
"s" = (
/obj/effect/turf_decal/tile/neutral,
/obj/effect/turf_decal/tile/neutral{
	dir = 8
	},
/obj/effect/turf_decal/tile/neutral{
	dir = 4
	},
/obj/effect/turf_decal/tile/neutral{
	dir = 1
	},
/obj/effect/mapping_helpers/smart_pipe/manifold4w/supply/hidden/layer4,
/obj/effect/mapping_helpers/smart_pipe/manifold4w/scrubbers/hidden/layer2,
/obj/machinery/door/window/survival_pod,
/obj/machinery/holopad/long_range,
/turf/open/floor/mineral/titanium/yellow,
/area/shuttle/mining/skyline)
"t" = (
/obj/effect/turf_decal/box/corners{
	dir = 1
	},
/obj/structure/window/reinforced{
	dir = 4
	},
/obj/machinery/atmospherics/components/unary/portables_connector/visible,
/obj/machinery/portable_atmospherics/canister/carbon_dioxide,
/obj/structure/window/reinforced{
	dir = 1
	},
/turf/open/floor/mineral/plastitanium,
/area/shuttle/mining/skyline)
"u" = (
/obj/effect/turf_decal/box/corners{
	dir = 4
	},
/obj/machinery/portable_atmospherics/canister/air,
/obj/machinery/atmospherics/components/unary/portables_connector/visible/layer4,
/obj/structure/window/reinforced{
	dir = 4
	},
/obj/structure/window/reinforced{
	dir = 8
	},
/obj/structure/window/reinforced{
	dir = 1
	},
/turf/open/floor/mineral/plastitanium,
/area/shuttle/mining/skyline)
"v" = (
/obj/docking_port/mobile{
	dwidth = 3;
	height = 10;
	id = "mining";
	name = "salvage shuttle";
	port_direction = 2;
	width = 7;
	dir = 8
	},
/obj/machinery/door/airlock/external{
	name = "Mining Shuttle External Airlock"
	},
/obj/effect/mapping_helpers/airlock/cyclelink_helper{
	dir = 8
	},
/obj/structure/cable,
/obj/effect/mapping_helpers/smart_pipe/manifold4w/orange/visible,
/obj/effect/mapping_helpers/smart_pipe/manifold4w/scrubbers/hidden/layer2,
/turf/open/floor/mineral/titanium/yellow,
/area/shuttle/mining/skyline)
"w" = (
/obj/effect/turf_decal/box/corners{
	dir = 1
	},
/obj/effect/mapping_helpers/airlock/cyclelink_helper{
	dir = 4
	},
/obj/machinery/door/airlock/external{
	name = "Mining Shuttle External Airlock"
	},
/obj/effect/mapping_helpers/smart_pipe/manifold4w/supply/hidden/layer4,
/obj/structure/cable,
/obj/effect/mapping_helpers/smart_pipe/manifold4w/scrubbers/hidden/layer2,
/obj/effect/mapping_helpers/smart_pipe/manifold4w/orange/visible,
/turf/open/floor/mineral/titanium/yellow,
/area/shuttle/mining/skyline)
"x" = (
/obj/effect/turf_decal/box/corners{
	dir = 8
	},
/obj/effect/mapping_helpers/smart_pipe/manifold4w/orange/visible,
/turf/open/floor/mineral/plastitanium,
/area/shuttle/mining/skyline)
"y" = (
/obj/effect/decal/cleanable/dirt,
/obj/effect/turf_decal/box/corners{
	dir = 4
	},
/obj/machinery/atmospherics/components/unary/vent_pump/on/layer4{
	dir = 8
	},
/obj/structure/cable,
/obj/effect/mapping_helpers/smart_pipe/manifold4w/scrubbers/hidden/layer2,
/obj/effect/mapping_helpers/smart_pipe/manifold4w/orange/visible,
/obj/structure/window/reinforced{
	dir = 1
	},
/turf/open/floor/mineral/titanium/yellow,
/area/shuttle/mining/skyline)
"z" = (
/obj/effect/turf_decal/box/corners,
/obj/machinery/atmospherics/components/binary/pump/layer4{
	name = "air supply pump"
	},
/obj/item/wrench,
/obj/machinery/atmospherics/components/unary/vent_scrubber/on/layer2,
/turf/open/floor/mineral/plastitanium,
/area/shuttle/mining/skyline)
"A" = (
/obj/effect/turf_decal/stripes/line{
	dir = 8
	},
/obj/effect/mapping_helpers/smart_pipe/manifold4w/supply/hidden/layer4,
/obj/structure/cable,
/obj/effect/mapping_helpers/smart_pipe/manifold4w/scrubbers/hidden/layer2,
/obj/effect/mapping_helpers/smart_pipe/manifold4w/orange/visible,
/turf/open/floor/mineral/titanium/yellow,
/area/shuttle/mining/skyline)
"B" = (
/obj/structure/window/reinforced{
	dir = 8
	},
/obj/effect/turf_decal/box/corners{
	dir = 1
	},
/obj/structure/window/reinforced{
	dir = 1
	},
/turf/open/floor/mineral/plastitanium,
/area/shuttle/mining/skyline)
"C" = (
/turf/closed/wall/mineral/titanium,
/area/shuttle/mining/skyline)
"E" = (
/obj/machinery/atmospherics/components/unary/vent_scrubber/on/layer2{
	dir = 1
	},
/obj/effect/turf_decal/box/corners{
	dir = 4
	},
/turf/open/floor/mineral/plastitanium,
/area/shuttle/mining/skyline)
"F" = (
/obj/machinery/atmospherics/components/unary/engine,
/turf/open/floor/plating/airless,
/area/shuttle/mining/skyline)
"G" = (
/obj/effect/turf_decal/stripes/line{
	dir = 1
	},
/obj/machinery/atmospherics/components/unary/vent_pump/on/layer4{
	dir = 4
	},
/obj/effect/turf_decal/box,
/obj/machinery/airalarm/directional/west,
/obj/machinery/light/directional/west,
/obj/effect/mapping_helpers/smart_pipe/manifold4w/orange/visible,
/turf/open/floor/mineral/titanium/yellow,
/area/shuttle/mining/skyline)
"H" = (
/obj/effect/turf_decal/bot,
/obj/effect/turf_decal/stripes/line{
	dir = 1
	},
/obj/effect/mapping_helpers/smart_pipe/manifold4w/supply/hidden/layer4,
/obj/machinery/power/apc/auto_name/south,
/obj/structure/cable,
/obj/machinery/power/port_gen/pacman{
	anchored = 1
	},
/obj/item/stack/sheet/mineral/plasma/five,
/obj/effect/mapping_helpers/smart_pipe/manifold4w/scrubbers/hidden/layer2,
/obj/effect/mapping_helpers/smart_pipe/manifold4w/orange/visible,
/turf/open/floor/mineral/titanium/yellow,
/area/shuttle/mining/skyline)
"I" = (
/obj/effect/turf_decal/stripes/corner{
	dir = 1
	},
/obj/effect/mapping_helpers/smart_pipe/manifold4w/supply/hidden/layer4,
/obj/structure/cable,
/obj/effect/turf_decal/box,
/obj/effect/mapping_helpers/smart_pipe/manifold4w/scrubbers/hidden/layer2,
/obj/effect/mapping_helpers/smart_pipe/manifold4w/orange/visible,
/obj/structure/window/reinforced{
	dir = 4
	},
/turf/open/floor/mineral/titanium/yellow,
/area/shuttle/mining/skyline)
"J" = (
/obj/structure/tank_dispenser/oxygen,
/obj/machinery/light/directional/east,
/obj/effect/mapping_helpers/smart_pipe/manifold4w/orange/visible,
/obj/effect/turf_decal/box/corners,
/turf/open/floor/mineral/plastitanium,
/area/shuttle/mining/skyline)
"K" = (
/obj/structure/shuttle/engine/heater,
/obj/structure/window/reinforced{
	dir = 1
	},
/obj/effect/mapping_helpers/smart_pipe/manifold4w/orange/visible,
/turf/open/floor/plating,
/area/shuttle/mining/skyline)
"L" = (
/turf/closed/wall/mineral/titanium/nodiagonal,
/area/shuttle/mining/skyline)
"N" = (
/obj/effect/decal/cleanable/dirt,
/obj/effect/turf_decal/stripes/line{
	dir = 9
	},
/obj/structure/window/reinforced,
/obj/effect/turf_decal/box/corners{
	dir = 8
	},
/obj/effect/turf_decal/box/corners{
	dir = 1
	},
/obj/structure/closet/crate,
/turf/open/floor/mineral/plastitanium,
/area/shuttle/mining/skyline)
"Q" = (
/obj/effect/mapping_helpers/smart_pipe/manifold4w/orange/visible,
/obj/structure/window/reinforced{
	dir = 8
	},
/obj/structure/closet/crate/medical,
/obj/item/storage/firstaid/regular,
/obj/item/storage/firstaid/regular{
	pixel_x = 3;
	pixel_y = -3
	},
/obj/effect/turf_decal/box/corners{
	dir = 8
	},
/turf/open/floor/mineral/plastitanium,
/area/shuttle/mining/skyline)
"W" = (
/obj/effect/turf_decal/stripes/line{
	dir = 8
	},
/obj/effect/mapping_helpers/smart_pipe/manifold4w/supply/hidden/layer4,
/obj/structure/cable,
/obj/effect/mapping_helpers/smart_pipe/manifold4w/scrubbers/hidden/layer2,
/obj/effect/mapping_helpers/smart_pipe/manifold4w/orange/visible,
/obj/structure/window/reinforced{
	dir = 4
	},
/turf/open/floor/mineral/titanium/yellow,
/area/shuttle/mining/skyline)

(1,1,1) = {"
a
a
L
L
L
L
q
L
C
a
"}
(2,1,1) = {"
a
q
L
l
j
t
x
G
K
F
"}
(3,1,1) = {"
q
q
g
m
c
u
z
H
L
L
"}
(4,1,1) = {"
q
d
h
n
s
A
W
I
K
F
"}
(5,1,1) = {"
q
q
i
o
N
w
B
Q
L
L
"}
(6,1,1) = {"
a
q
L
p
f
y
E
J
K
F
"}
(7,1,1) = {"
a
a
e
L
L
v
q
C
C
a
"}
